0. 0. 0. 0. 0. 0. 0. 0. 0. 0. 0. 0. 0. 0. 0. 0. 0. 0. 0. 0.
0. 1. 1. 1. 1. 1. 1. 1. 1. 1. 1. 1. 1. 1. 1. 1. 1. 1. 1. 0.
0. 1. F. F. 1. F. F. 1. F. F. 1. F. F. 1. F. F. 1. F. 1. 0.
0. 1. F. 1V 1. F. 1. 1K 1. 2T 2. 1. 3H 1. F. F. 1. F. 1. 0.
0. 1. F. F. 1. F. F. 1. F. 2. 2. F. F. 1. F. F. 1. F. 1. 0.
0. 1. 1. 1. 1. 1. 1. 1. 1. 1. 2. 2. 1. 1. 1. 1. 1. 1. 1. 0.
0. 1. 1. 2V 1. 1. 1. 1. 1. 1. 1. 1. 1. 1. 1. 1. 1. 1. 1. 0.
0. 1. F. F. 1. F. F. 1. F. F. 1. F. F. 1. F. F. 1. F. 1. 0.
0. 1. F. 1. 1. 1. F. 1. 1. 1. F. 1. 1. 1. F. 1. 1. F. 1. 0.
0. 1. 1. 1. 3K 1. 1. 1. 1. 1. 1. 1. 1. 1. 1. 1. 1. 1. 1. 0.
0. 1. 1. 1. 1. 1. 1. 1. 1. 1. 1. 1. 1. 1. 1. 1. 1. 2H 1. 0.
0. 1. F. 1. F. 1. F. 1. F. 1. F. 1. F. 1. F. 1. F. 1. 1. 0.
0. 1. F. F. F. F. F. 1. F. F. F. F. F. 1. F. F. F. F. 1. 0.
0. 1. 1. 1. 1. 1. 1. 1. 1. 1. 1. 1. 1. 1. 1. 1. 1. 1. 1. 0.
0. 1. F. F. 1. F. F. 1. F. F. 1. F. F. 1. F. F. 1. F. 1. 0.
0. 1. F. 1. 1. 1. F. 1. 1. 1. F. 1. 1. 1. F. 1. 1. F. 1. 0.
0. 1. 1. 4V 1. 1. 1. 1. 1. 1. 1. 1. 1. 1. 1. 1. 1. 1. 1. 0.
0. 1. 1. 1. 1. 1. 1. 5T 5C 0A 5V 5P 5K 5H 5B 1. 1. 1. 1. 0.
0. W. W. W. W. W. W. W. W. W. W. W. W. W. W. W. W. W. W. 0.
0. 0. 0. 0. 0. 0. 0. 0. 0. 0. 0. 0. 0. 0. 0. 0. 0. 0. 0. 0.