S. S. S. F. F. F. F. 1. S. S. S.
S. S. 2. 3. T. T. 1. 1. S. S. S.
S. F. 2. 2. 3. S. S. 3. 3. TA S.
1. F. F. 3. T. S. 2. 2. TB F. S.
S. 1. 1. 3. 2T TB T. 2. F. F. S.
1. 2. TB 2C 2. 1. 1T T. 1. F. S.
S. 2. 3. 3. 2. 1. 1C T. T. T. 1.
S. T. 3. 3. F. 1. TB T. T. 1. S.
S. 2. 2. S. S. F. F. 3. 3. 1. S. 
S. 2. 2. TA S. 1. 3. 3. S. S. S.
S. S. S. TB T. 1. F. S. S. S. S.
S. S. S. T. 1. F. S. S. S. S. S.