W. W. W. F. F. F. F. 1. W. W. W.
W. W. 2. 3. T. T. 1. 1. W. W. W.
W. F. 2. 2. 3. W. W. 3. 3. TA W.
1. F. F. 3. T. W. 2. 2. TB F. W.
W. 1. 1. 3. 2T TB T. 2. F. F. W.
1. 2. TB 2C 2. 1. 1T T. 1. F. W.
W. 2. 3. 3. 2. 1. 1C T. T. T. 1.
W. T. 3. 3. F. 1. TB T. T. 1. W.
W. 2. 2. W. W. F. F. 3. 3. 1. W. 
W. 2. 2. TA W. 1. 3. 3. W. W. W.
W. W. W. TB T. 1. F. W. W. W. W.
W. W. W. T. 1. F. W. W. W. W. W.