W. W. W. F. F. F. F. 1. W. W. W.
W. W. 2. 4. 0. 0. 1. 1. W. W. W.
W. F. 2. 2. 4. W. W. 4. 4. 0A W.
1. F. F. 4. 0. W. 2. 2. 0B F. W.
W. 1. 1. 4. 2T 0B 0. 2. F. F. W.
1. 2. 0B 2C 2. 1. 1T 0. 1. F. W.
W. 2. 4. 4. 2. 1. 1C 0. 0. 0. 1.
W. 0. 4. 4. F. 1. 0B 0. 0. 1. W.
W. 2. 2. W. W. F. F. 4. 4. 1. W. 
W. 2. 2. 0A W. 1. 4. 4. W. W. W.
W. W. W. 0B 0. 1. F. W. W. W. W.
W. W. W. 0. 1. F. W. W. W. W. W.