W. W. W. 2V 2. W. W. W. W. W.
W. W. 2. 2T T. F. F. F. W. W.
W. W. W. W. T. 1. F. 2. 2T 2.
W. W. W. W. 1V 1T T. 2V 2. W.
W. 1V F. F. T. T. T. T. W. W.
1. 1T T. F. 1. 1. T. W. W. W. 
W. 1. T. T. T. 1. T. 3. W. W. 
W. T. T. 1V T. T. 3V 3T W. W. 
W. T. T. 1. 1T W. T. 3. W. W.
T. 3V F. F. W. W. T. 3. W. W. 
W. 3T 3. W. W. W. W. T. W. W.