S. S. S. 2V 2. S. S. S. S. S.
S. S. 2. 2T T. F. F. F. S. S.
S. S. S. S. T. 1. F. 2. 2T 2.
S. S. S. S. 1V 1T T. 2V 2. S.
S. 1V F. F. T. T. T. T. S. S.
1. 1T T. F. 1. 1. T. S. S. S. 
S. 1. T. T. T. 1. T. 3. S. S. 
S. T. T. 1V T. T. 3V 3T S. S. 
S. T. T. 1. 1T S. T. 3. S. S.
T. 3V F. F. S. S. T. 3. S. S. 
S. 3T 3. S. S. S. S. T. S. S.